Декодирование (четвертая и пятая буквы)
- четвертая и пятая буквы обозначают условие, относящееся к предмету сообщения (вид опасности и эксплуатационное состояние).

Наличие (А)
AC – снято для технического обслуживания
AD – используется в наличии для дневных полетов
AH – часы обслуживания….(указать)
AK – возобновлена нормальная работа
AN – используется для ночных полетов
AO – работает
AP – используется по предварительному разрешению
AR – используется по запросу
AS – не используется
AX – предварительное извещение о выключении отменено

Изменение (С)
CA – включено
CC – завершено
CD – выключено
CE – смонтировано
CF – рабочая частота (рабочие частоты) изменена (изменены) на…
CI – опознавание или позывной для радиосвязи изменены
CM – смещенный
CN – аннулированный
CO – в рабочем состоянии

Опасные условие (Н)
HA – эффекттивность торможения
1)	плохая
2)	средняя/плохая
3)	средняя
4)	средняя/хорошая
5)	хорошая
HD – покрыто сухим снегом на толщину
HE – покрыто водой на толщину
HF – полностью свободно от мнега и льда
HI – покрыто льдом
HK – миграция птиц (указать направление)
HR – стоячая вода
HV – работа закончена
HW – ведутся работы
HX – скопление птиц
LC – закрыто
LD – небезопасно
LH – непригодно для воздушных судов, тяжелее
LI – закрыто для полетов по ППП
LN – закрыто для всех ночных полетов
LT – ограничено до
LV – закрыто для полетов по ПВП

Прочая информация (ХХ)
ХХ – открытый текст
