Декодирование (вторая и третья буквы).
- вторая и третья буквы означают предмет сообщения (вид средства или условия);

AGA (аэродромы)
Светотехническое оборудование (L)
LA – система огней приближения
LB – аэродромный светомаяк
LC – огни осевой линии ВПП (указать ВПП)
LH – огни ВПП высокой интенсивности
LI – ограничительные опознавательные огни ВПП
LJ – огни указателя входа в створ ВПП
LS – огни концевой полосы безопасности
LV – система визуальной индикации глиссады
LZ – огни зоны приземления

AGA
Рабочая площадь и посадочная площадка (М)
MA – рабочая площадь
MB – несущая способность
MC – полоса, свободная от препятствий
MD – объявленные расстояния
MH – тормозная установка на ВПП
MK – место стоянки
MM – дневная маркировка
MR – ВПП
MT – порог

AGA
Средства оборудование и обслуживание (F)
FA – аэродром
FH – зона приводнения/платформа для вертолетов
FL – указатель  направления посадки
FS – оборудование для удаления снега
FU – наличие топлива
FZ – таможенная служба

COM (связь)
Средства связи и наблюдения (С)
CA – оборудование связи «воздух-земля»
CE – маршрутный обзорный радиолокатор
CG – радиолокационная система посадки по команде с земли
CP – радиолокатор точного захода на посадку
CR – обзорный радиолокатор радиолокационной системы точного захода
CS – вторичный обзорный радиолокатор
CT – обзорный радиолокатор аэродромной зоны

COM
Системы захода по приборам и микроволновая система посадки (I)
IC – система посадки по приборам
ID – DME, взаимодействующая с системой ILS
IG – глиссада ILS
II – внутренний маркер ILS
IL – курсовой радиомаяк ILS
IM – средний маркер ILS
IO – внешний маркер ILS
IS – ILS категории I
IT – ILS категории II
IU – ILS категории III

COM
Аэродромные и маршрутные навигационные средства (N)
NA – все радионавигационные средства (за исключением….)
NB – ненапрвленный радиомаяк
ND – дальномерное оборудование
NG – глобальная навигационная спутниковая система
NL – приводная радиостанция (позывной)
NM – маяк VOR/DME
NN – система TACAN
NO – система OMEGA
NT – система VORTAC
NV – маяк VOR
NX – пеленгаторная станция (тип и частота)

RAC (правила полетов и обслуживания воздушного движения)
Организация воздушного пространства (А)
AA – минимальная абсолютная высота (маршрут/пересечение/безопасная высота)
AC – диспетчерская зона
AD – опознавательная зона ПВО
AE – диспетчерский район
AF – район полетной информации
AH – верхний диспетчерский район
AL – минимальный используемый эшелон полета
AN – маршрут зональной навигации
AP – контрольный пункт (наименование или кодированное обозначение)
AR – маршрут ОВД

RAC
Правила воздушного движения (Р)
PA – стандатрная схема прибытия по приборам (обозначение маршрута)
PB – стандартная схема прибытия по ПВП
PD – стандартный вылет приборам (обозначение маршрута)
PE – стандартный вылет по ПВП
PH – полет в зоне ожидания
PI – порядок захода на посадку по приборам
PK – схема захода на посадку по ПВП
PM – эксплуатационные минимумы аэродрома
PO – абсолютная высота пролета препятствий
PP – относительная высота пролета препятствий
PX – минимальная абсолютная высота полета в зоне ожидания

Навигационные предупреждения
Ограничения воздушного пространства (R)
RA – резервирование воздушного пространства (указать)
RD – опасная зона (указать национальный индекс и номер)
RP – запретная зона (указать национальный индекс и номер)
RR – зона ограничения полетов (указать национальный индекс и номер)
RT – зона временного ограничения полетов (указать зону)

Национальные предупреждения
Предупреждения (W)
WB – выполнение фигур высшего пилотажа
WD – подрыв взрывчатых веществ
WE – учения (указать)
WM – пуски ракет, стрельба из пушек или стредьба ракетами

Прочая информация(О)
OA – служба аэронавигационной информации
OB – препятствие (указать пподробности)
OE – требование к входу воздушного судна
OL – заградительные огни на….(указать)
OR – координационный центр поиска и спасания

